................................................................
.^^^^^^^^^^^^^^^^^^^^^^^^^^^^...................................
................................................................
.....~~~~~~~....................................................
................................................................
..#########.....................................................
................................................................
...............*................................................
................................................................
.^^^^^^^^^^^^^^^^^^^^^^^^^^^^...................................
................................................................
.....~~~~~~~....................................................
................................................................
.............................#########..........................
................................................................
...............*................................................
................................................................
..........................^^^^^^^^^^^^^^^^^^^^^^^^^^^^..........
................................................................
.....~~~~~~~....................................................
................................................................
..#########.....................................................
................................................................
...............*................................................
................................................................
.^^^^^^^^^^^^^^^^^^^^^^^^^^^^...................................
................................................................
.....~~~~~~~....................................................
................................................................
..#########.....................................................
................................................................
...............*................................................